WWWWWWWWWWWWWWWWWWWWWWWWWWWWWWWWWWWWWWWWWWWWWWWWWWWWWWWWWWWWWWWWWWWWWWWWWWWWWWWW
W T           T W T           T W T           T W T           T W T          T W
W               W               W               W               W              W
W               W               W               W               W              W
W T           T W T           T W T           T W T           T W T          T W
WWWWWWWWWWWWWWWWWWWWWWWWWWWWWWWWWWWWWWWWWWWWWWWWWWWWWWWWWWWWWWWWWWWWWWWWWWWWWWWW
W T           T W T           T W T           T W T           T W T          T W
W               W               W               W               W              W
W               W               W               W               W              W
W T           T W T           T W T           T W T           T W T          T W
WWWWWWWWWWWWWWWWWWWWWWWWWWWWWWWWWWWWWWWWWWWWWWWWWWWWWWWWWWWWWWWWWWWWWWWWWWWWWWWW
W T           T W T           T W T           T W T           T W T          T W
W               W               W               W               W              W
W               W               W               W               W              W
W T           T W T           T W T           T W T           T W T          T W
WWWWWWWWWWWWWWWWWWWWWWWWWWWWWWWWWWWWWWWWWWWWWWWWWWWWWWWWWWWWWWWWWWWWWWWWWWWWWWWW
W T           T W T           T W T           T W T           T W T          T W
W               W               W               W               W              W
W               W               W               W               W              W
W T           T W T           T W T           T W T           T W T          T W
WWWWWWWWWWWWWWWWWWWWWWWWWWWWWWWWWWWWWWWWWWWWWWWWWWWWWWWWWWWWWWWWWWWWWWWWWWWWWWWW
W                                                                              W
W                                                                              W
W                                                                              W
WWWWWWWWWWWWWWWWWWWWWWWWWWWWWWWWWWWWWWWWWWWWWWWWWWWWWWWWWWWWWWWWWWWWWWWWWWWWWWWW