wwwwwwwwwwwwwwwwwwwwwwwwwwwwwwwwwwwwwwwwwwwwwwwwwwwwwwwwwwwwwwwwwwwwwwwwwwwwwwww
w T           T w T           T w T           T w T           T w T          T w
w               w               w               w       B       w      B       w
w               w               w               w       B       w      B       w
w T           T w T           T w T           T w T           T w T    K     T w
wwwwwwwwwwwwwwwwwwwwwwwwwwwwwwwwwwwwwwwwwwwwwwwwwwwwwwwwwwwwwwwwwwwwwwwwwwwwwwww
w T           T w T           T w T           T w T           T w T          T w
w               w               w       B       w       B       w      B       w
w               w               w       B       w       B       w      B       w
w T           T w T           T w T           T w T           T w T          T w
wwwwwwwwwwwwwwwwwwwwwwwwwwwwwwwwwwwwwwwwwwwwwwwwwwwwwwwwwwwwwwwwwwwwwwwwwwwwwwww
w T           T w T           T w T           T w T           T w T          T w
w               w               w       B       w       B       w      B       w
w               w               w       B       w       B       w      B       w
w T           T w T           T w T           T w T           T w T          T w
wwwwwwwwwwwwwwwwwwwwwwwwwwwwwwwwwwwwwwwwwwwwwwwwwwwwwwwwwwwwwwwwwwwwwwwwwwwwwwww
w T           T w T           T w T           T w T           T w T          T w
w               w               w       B       w       B       w      B       w
w               w               w       B       w       B       w      B       w
w T           T w T           T w T           T w T           T w T          T w
wwwwwwwXwwwwwwwwwwwwwwwwwwwwwwwwwwwwwwwwwwwwwwwwwwwwwwwwwwwwwwwwwwwwwwwwwwwwwwww
w                                                                              w
w                                                                              P
w                                                                              w
wwwwwwwwwwwwwwwwwwwwwwwwwwwwwwwwwwwwwwwwwwwwwwwwwwwwwwwwwwwwwwwwwwwwwwwwwwwwwwww