WWWWWWWWWWWWWWWWWWWWWWWWWWWWWWWWWWWWWWWWWWWWWWWWWWWWWWWWWWWWWWWWWWWWWWWWWWWWPWWW
W...W......T........W...............W...........W...................W....W..B..W
W...W...WWWWWWWWW...W...WWWWW...WWWWWWWWW...WWWWW...WWWWW...WWWWW...W....W.....W
W...............W.......W...W...........W...........W.T.W...W.......W....W.....W
WWWWWWWWW...W...WWWWWWWWW...WWWWWWWWW...WWWWW...W...W...W...WWWWWWWWW....W.....W
W.......W...W.............B.W...........W...W...W...W...W...........W....W.....W
W...W...WWWWWWWWWWWWW...W...W...WWWWWWWWW...WWWWW...W.B.WWWWWWWWW...W....W.....W
W...W...............W...W...W.......W.....B.....W...........W.......W....W.....W
W...WWWWWWWWWWWWW...WWWWW...WWWWW...W...WWWWW...WWWWWWWWW...W...WWWWW....W.....W
W...........W.......W...W.......W...W.......W...........W...W............W.....W
W...WWWWW...WWWWW...W...WWWWW...W...WWWWWWWWW...W...W...W...WWWWWWWWWWWW.W.....W
W....T..W.......W...W...W.......W.......W.......W...W...W.......W........W.....W
WWWWWWWWWWWWW...W...W...W...WWWWWWWWW...W...WWWWW...W...WWWWW...WWWWW....W.....W
W...........W...W.....B.....W.......W...W.......W...W.B.....W..........B.W.....W
W...WWWWW...W...WWWWWWWWW...WWWWW...W...WWWWW...WWWWW...WWWWWWWWWWWWW....W.....W
W...W.......W...........W...........W.......W...W...W...............W....W.....W
W...W...WWWWWWWWW...W...WWWWW...WWWWWWWWW...W...W...WWWWWWWWWWWWW...W....W.....W
W...W...........W...W...W...W...W...........W...............W...W........W.....W
W...WWWWWWWWW...W...W...W...WWWWW...WWWWWWWWW...WWWWWWWWW...W...WWWWWWWWWWWW.WWW
W...W.......W...W...W.B.........W...........W...W.......W...B.........T..W.....W
W...W...WWWWW...WWWWW...WWWWW...WWWWWWWWW...WWWWW...W...WWWWWWWWW...W.... .....W
W...W...................W...........W...............W...............W....W.....W
W...WWWWWWWWWWWWWWWWWWWWWWWWWWWWWWWWWWWWWWWWWWWWWWWWWWWWWWWWWWWWWWWWWWWWWWWWWWWW
W.......................B..........................B........................K..W
WWWWWWWWWWWWWWWWWWWWWWWWWWWWWWWWWWWWWWWWWWWWWWWWWWWWWWWWWWWWWWWWWWWWWWWWWWWWWWWW
